0 0 6 0 8 1 2 0 0
0 0 0 6 3 9 8 0 0
3 0 8 0 0 0 0 6 9
1 0 0 0 0 6 4 0 7
4 2 0 1 0 0 3 0 0
0 6 3 0 0 4 0 8 0
0 5 7 0 0 3 6 0 0
0 0 1 0 0 7 0 3 2
6 3 4 0 0 0 0 7 0
