0 0 6 0 0 1 2 0 0
0 0 0 6 3 0 8 0 0
3 0 8 0 0 0 0 6 0
1 0 0 0 0 6 0 0 7
0 2 0 1 0 0 3 0 0
0 0 3 0 0 4 0 8 0
0 0 7 0 0 3 6 0 0
0 0 1 0 0 0 0 3 2
6 3 0 0 0 0 0 7 0
